111111
1P0C01
1000011
1C0E01
111111
