111111
1P0C01
10000E
1C0C01
11111
