1111111111111111111
1P00000000000000001
1000111111000111101
1C001000000000000C1
1111010111111111001
1C00010000000001001
1000111000111111001
1C00000000000000001
1111011111111111001
1C00010000000001001
1000111000111111001
1C00000000000000001
1111011111111111001
1C0001000000C001001
1000111000111111001
1C00000000000000001
1111011111111111001
1C00000000000000E01
1111111111111111111
