111111
1P0001
111111
1E00C1
111111
