11111111111111111111
1P0000000000110000C1
10001111110001111001
1C0010000000000000C1
11110101111111110001
1C00010000C000010001
10001110001111110001
1C0000E0000000000C01
11111111111111111111
