111111
1P0C01
100001
1C0C01
111111
